╔══════════╗  ╔══════════╗╔══════╗
║          ╚══╝          ║║   *  ║
║                        ║║      ║
║          ╔══╗          ║║      ║
╚══════════╝  ╚═══╗  ╔═══╝║      ║
                  ║  ║    ║      ║
                  ║  ║    ║      ║
╔══════════╗  ╔═══╝  ╚═══╗║      ║
║          ╚══╝          ║║      ║
║                        ║║      ║
║          ╔══╗          ║║      ║
╚═════╗  ╔═╝  ╚══════════╝║      ║
      ║  ║                ║      ║
      ║  ║                ║      ║
╔═════╝  ╚═════════════╗  ║      ║
║                      ╚══╝      ║
║                                ║
║                      ╔══╗      ║
╚══════════════════════╝  ╚══════╝