╔═════════╗  ╔═════════╗
║         ╚══╝         ║
║                      ║
║         ╔══╗         ║
╚═════════╝  ╚═══╗ ╔═══╝
                 ║ ║    
                 ║ ║    
╔═════════╗  ╔═══╝ ╚═══╗
║         ╚══╝         ║
║                      ║
║         ╔══╗         ║
╚═════════╝  ╚═════════╝